FWWWWWWWWWWWWWWWWWWWF
FW........W........WF
FWOWW.WWW.W.WWW.WWOWF
FW........F........WF
FW.WW.W.WWWWW.W.WW.WF
FW....W...W...W....WF
FWWWW.WWWFWFWWW.WWWWF
FFFFW.WFFFRFFFW.WFFFF
WWWWW.WFWWDWWFW.WWWWW
FFFFFFFFWBPYWFFFFFFFF
WWWWW.WFWWWWWFW.WWWWW
FFFFW.WFFF-FFFW.WFFFF
FWWWW.WFWWWWWFW.WWWWF
FW........W........WF
FW.WW.WWW.W.WWW.WW.WF
FWO.W.....1.....W.OWF
FWW.W.W.WWWWW.W.W.WWF
FW....W...W...W....WF
FW.WWWWWW.W.WWWWWW.WF
FW.................WF
FWWWWWWWWWWWWWWWWWWWF