FFFFFFFFFFFFFFF
FFFFFFFFFFFFFFF
FFFFFFFFFFFFFFF
FWWFWWFFFFFFFFF
FFWWWWFFFFFFFFF
FFWFFFFFFFFFFFF
FFWWWFFFFFFFFFF
FFFFWFFFFFFFFFF
FFFFFFFFFFFFFFF
FFFFFFFFFFFFFFF
FFFFFFFFFFFFFFF
FFFFFFFFFFFFFFF
FFFFFFFFFFFFFFF
FFFFFFFFFFFFFFF
FFFFFFFFFFFFFFF
