FWWWWWWWWWWWWWWWWWWWF
FWFFFFFFFFWFFFFFFFFWF
FWFWWFWWWFWFWWWFWWFWF
FWFFFFFFFFFFFFFFFFFWF
FWFWWFWFWWWWWFWFWWFWF
FWFFFFWFFFWFFFWFFFFWF
FWWWWFWWWFWFWWWFWWWWF
FFFFWFWFFFFFFFWFWFFFF
WWWWWFWFWWDWWFWFWWWWW
FFFFFFFFWFFFWFFFFFFFF
WWWWWFWFWWWWWFWFWWWWW
FFFFWFWFFFFFFFWFWFFFF
FWWWWFWFWWWWWFWFWWWWF
FWFFFFFFFFWFFFFFFFFWF
FWFWWFWWWFWFWWWFWWFWF
FWFFWFFFFFFFFFFFWFFWF
FWWFWFWFWWWWWFWFWFWWF
FWFFFFWFFFWFFFWFFFFWF
FWFWWWWWWFWFWWWWWWFWF
FWFFFFFFFFFFFFFFFFFWF
FWWWWWWWWWWWWWWWWWWWF